createRandomMaze
1 1 0 1 0
1 1 1 1 0
1 0 0 0 1
1 0 0 0 0
1 0 1 0 1

1 1 0 1 0
1 1 1 1 0
0 0 1 1 1
1 1 1 1 1
0 1 0 1 1

0 0 1 1 0
0 1 1 0 0
0 1 1 1 0
1 1 1 0 1
0 1 0 0 1

1 0 0 1 1
1 0 0 1 1
0 1 0 0 0
0 0 1 1 1
0 0 1 1 0

0 1 0 0 1
1 1 0 1 1
1 0 1 1 1
0 0 1 1 0
1 1 0 0 1

Path: Unsolvable
createRandomMaze
1 0 1 0 1
0 0 1 0 0
0 1 0 0 0
1 0 0 0 1
0 0 1 1 1

1 0 1 1 0
0 1 1 1 1
0 1 0 1 1
0 0 0 0 0
0 1 0 1 1

0 1 0 1 0
1 1 0 0 0
0 0 1 1 0
1 0 1 1 1
1 1 1 1 0

0 0 1 0 1
1 0 0 1 0
0 0 1 0 1
1 0 1 1 0
1 0 0 1 1

1 0 0 1 1
0 1 1 0 1
0 1 0 0 0
0 0 0 1 0
1 0 1 1 1

Path: Unsolvable
createRandomMaze
1 0 1 1 1
0 0 1 1 1
1 1 0 0 1
0 1 0 0 1
0 0 0 1 1

0 0 1 1 1
1 0 0 0 1
1 1 0 1 0
1 0 1 0 0
1 0 1 1 0

1 0 0 1 1
1 1 1 0 1
1 1 1 1 0
1 0 1 1 1
1 0 1 0 0

0 1 0 1 1
0 0 1 0 1
0 1 1 1 0
0 0 1 1 1
1 0 0 0 1

1 1 0 1 0
0 1 1 1 0
0 1 1 1 0
0 1 1 1 1
1 1 1 1 1

Path: Unsolvable
createRandomMaze
1 0 1 1 1
1 0 0 1 1
0 1 0 0 0
1 0 0 0 0
0 0 1 1 0

0 1 1 0 0
0 1 0 0 0
1 1 0 0 0
0 0 1 0 0
0 1 1 0 1

1 0 0 0 1
0 1 0 1 1
0 0 0 1 0
0 0 1 0 0
1 0 1 0 1

1 0 0 0 0
0 1 0 0 0
0 0 1 0 1
0 1 1 0 0
1 0 0 0 0

1 1 1 0 0
0 1 0 0 0
1 0 1 1 0
1 1 0 0 0
0 0 1 1 1

Path: Unsolvable
createRandomMaze
1 1 0 1 1
1 0 1 0 0
1 0 0 1 0
0 0 1 1 0
1 1 1 0 1

1 0 0 0 1
0 1 0 1 1
0 0 1 1 0
0 0 0 0 1
0 0 0 1 1

0 1 0 1 1
0 1 1 0 1
0 0 1 1 1
0 1 1 1 0
1 1 0 1 1

1 0 1 1 1
1 1 0 1 1
1 1 0 0 1
1 1 0 0 0
1 0 1 1 0

1 0 1 1 0
1 0 0 0 0
1 1 1 0 1
0 1 0 0 0
0 0 1 0 1

Path: Unsolvable
createRandomMaze
1 1 1 0 0
1 1 1 0 0
1 1 0 1 0
0 0 1 0 0
0 0 0 1 1

0 1 1 1 1
1 0 0 0 0
1 1 1 0 0
1 1 1 1 0
1 0 0 1 0

1 1 0 1 0
1 1 1 0 0
0 0 0 1 0
0 0 0 1 0
0 0 1 1 1

1 1 1 1 0
1 0 1 0 1
0 1 0 1 0
0 0 0 0 1
0 0 1 0 1

1 0 1 0 0
1 1 1 0 0
1 0 1 0 0
0 0 1 1 0
1 1 0 1 1

VALID solution given
createRandomMaze
1 0 0 0 0
0 1 1 1 1
1 0 0 0 1
0 1 1 1 1
1 0 0 0 1

0 0 0 0 1
0 1 1 1 1
0 1 0 1 0
1 0 1 1 0
0 1 1 1 1

0 0 1 0 0
0 0 0 0 0
0 1 1 1 0
0 1 1 0 0
1 1 0 0 0

0 0 0 1 1
1 0 1 0 0
0 0 1 0 0
1 0 1 1 0
1 1 1 0 0

0 0 1 0 0
0 1 1 0 0
0 1 0 0 1
1 0 1 0 0
1 1 1 1 1

Path: Unsolvable
createRandomMaze
1 0 0 0 1
0 0 1 1 1
1 1 0 0 1
0 1 0 1 1
1 0 1 0 0

1 0 1 0 1
0 1 1 0 0
0 0 0 1 1
1 1 1 1 1
0 0 0 1 1

1 0 1 0 1
1 0 1 0 0
0 0 0 1 0
0 0 0 0 1
0 0 0 1 1

0 1 1 0 0
0 0 1 1 0
0 0 0 1 1
1 1 1 1 0
0 1 0 0 1

0 0 1 0 1
1 0 1 0 1
1 1 1 0 0
1 0 1 0 1
0 1 0 1 1

Path: Unsolvable
createRandomMaze
1 1 1 1 0
0 1 0 0 0
0 1 0 1 1
1 0 0 0 1
1 0 1 0 0

1 0 1 1 1
1 0 1 0 0
1 0 1 1 0
1 1 1 0 0
1 1 1 1 0

0 0 0 1 0
0 0 0 1 0
0 0 0 1 0
0 0 0 0 1
1 1 1 0 1

1 1 1 0 1
1 0 1 1 0
0 1 0 0 0
0 0 0 1 1
0 1 1 0 1

1 1 1 0 0
0 1 1 1 0
0 0 0 0 1
0 0 0 1 0
0 1 1 0 1

Path: Unsolvable
createRandomMaze
1 0 0 0 1
1 1 0 0 1
0 1 0 0 0
0 0 1 1 0
0 1 0 1 0

1 1 0 0 0
0 0 0 0 0
1 0 1 0 0
0 0 1 1 0
0 1 1 1 0

1 1 0 0 0
0 1 0 0 1
0 1 1 0 1
0 0 1 1 0
0 0 0 1 1

1 1 0 0 0
1 1 0 1 1
0 1 0 0 0
1 0 1 1 1
0 1 1 0 0

1 0 0 1 1
1 0 1 0 0
1 1 0 1 0
1 0 1 0 0
1 1 1 0 1

Path: Unsolvable
